**********G******************
*       *                   *
* ************************* *
* *            *            *
* ****** ****************** *
*              *            *
* ****** ****************** *
* *                         *
* ************************* *
* *       *         *       *
* ******* ********* *********
*                           *
****** ******* ****** ***** *
*            *            * *
****** * ********************
*   *  *      * *  * * *    *
* * * ********* ** * * **** * 
* *   * * * * *  * * *    * *
* *******   * ****** ********
*           *               *
* ********* * * *********** *
* *       * * * *         * *
* * ***** *   * *** *****   *
* * *   * ***** *       *****
* * * * *       * *******   *
* * * * ********* *       * *
* * * * *           ******* *
* *   * *************       *
* *****           * ******* *
*       ********* *   *   * *
********* * * * * * *   * * *
* * * * * * ***** * ******* *
* * * * * * *     *         *
*************S***************