********************************************************G*
*                                                        *
* ********************************************************
*     *       *          *          *               *    *
*  **** ************** ******** **  *  * ****** **** ** *
* **  *    *     *   *     *  *   ** **  *    *    *  * *
*     *    *    **** **** * ***** *   * ********** ***  *
*                                                        *
*S********************************************************