*****************************
*                          G*
*  **************************
*  *                        *
*  *                        *
*  *                        *
*                           *
*  *                        *
* **** ******* ***** ********
*  *      *     *           *
********************** ******
*                           *
*                           *
*************************** *
*                           *
*S***************************