********************************************************G*
*                                                        *
* ********************************************************
*     *       *          *          *               *    *
*  **** ************** ******** **  *  * ****** **** ** *
* **  *    *     *   *     *  *   ** **  *    *    *  * *
*  *  *    *    **** **** * ***** *   * ********** ***  *
*  *  *  ***                                             *
*                                                        *
*S********************************************************